XXXXXXXXXXXXXXXXXXXX
XXXXX..........XXXXX
XXX..............XXX
XX.....XXXXXX....XXX
X.....XXXXXXX.....XX
X.....XXXXXXX.....XX
X-----XXXXXXX.....XX
X..H..XXXXXX.....XXX
X.....XXXXX.....XXXX
X.....XXX.....XXXXXX
X.....XXX......XXXXX
X......XXX......XXXX
XXX.....XXXX......XX
XXX.....XXXX......XX
X......XXX........XX
X....XXXXX......XXXX
X..............XXXXX
XX............XXXXXX
XXXXX.......XXXXXXXX
XXXXXXXXXXXXXXXXXXXX
